------------------------------
-                            -
-            Z               -
-  P                ---      -
-                   ---      -
-                            -
-       ---           ---    -
-                            -
- --            --           -
-          --                -
-                            -
-   ---                      -
-                            -
-      --                    -
-                            -
-             ---            -
-       --                   -
-   ---                      -
-                            -
-                            -
------------------------------