------------------------------
-                            -
-                            -
-         *         ---      -
-                            -
-                            -
-         -           ---    -
-                     Z      -
- --             --      --  -
-          --                -
-                            -
-   ---                      -
-      P             -       -
-                            -
-                       -    -
-                            -
-                 +          -
-   ---               +      -
-        +          +     +  -
-            -               -
------------------------------